XXXXXXXXXXXXXXXXXXXXXXXXXXXXXXXXXXXXXXXX
X                                      X
X XXXXXXXXXXXXXXXXXXXXXXXXXXXXXXXXXXX  X
X X                                 X  X
X X  XXXXXXXXXXXXXXXXXXXXXXXXXXXXXX X  X
X X  X                            X X  X
X X  X XXXXXXXXXXXXXXXXXXXXXXXXXX X X  X
X X  X X                        X X X  X
X X  X X XXXXXXXXXXXXXXXXXXXXXX X X X  X
X X  X X XXXXXXXXXXXXXXXXXXXXXXXX X X  X
X X  X X                          X X  X
X X  X XXXXXXXXXXXXXXXXXXXXXXXXXXXX X  X
X X  X                              X  X
X X  XXXXXXXXXXXXXXXXXXXXXXXXXXXXXXXX  X
X X                                    X
X XXXXXXXXXXXXXXXXXXXXXXXXXXXXXXXXXXXXXX
